1111111111111111111111111111111111
1P000000000C00000000N00000000N0001
1000011100111110001111100011111001
1000100100000100000001000000001001
1000000100001000CN00100000C00010N1
1000000100C00110000001100000001001
1000000100000010000000100000001001
100000010011111000111110000N001N01
1C0C000000000000000000C000000000E1
1111111111111111111111111111111111