111111111111111111111111111111111111111111111111111111111111111111111111111111111111111111111111
1CCCCCCCCCCCCCCCCCCCCCCCCCCCCCCCCCCCCCCCCCCCCCCCCCCCCCCCCCCCCCCCCCCCCCCCCCCCCCCCCCCCCCCCCCC11111
100001110111110000000000011111111000000000000010001100111111111111111111111111111111111111111111
1P1111000000001111110000100000011111111111111110011101111001111111111111111111111111111111111111
100011000011110000000000000000000000000001111110111000000000000100001111111111111111111111111111
100111110000000000111111111000000000011111111110111111111111111100000111111111111111111111111111
100000000000000000000001000100000001000000000010001000111111111111100000111111111111111111111111
100E00000000000000011111111111000000000000000110111001111111111111111101111111111111111111111111
100000000000000000010000000000001111111111111110001000111100000011111100111111111111111111111111
100000000000000000010011111110000000000000000000001000000000110000000001111111111111111111111111
111111111111111111111111111111111111111111111111111111111111111111111111111111111111111111111111