11111111111111111111111111
1PN0C0000000000C0000000001
100000000000000000C0001001
10000000000000000100000001
1000C00000000000C000000001
100000000C00000000C0000001
10000000000011000000010001
10000000000001000C000C0001
10100C00000000C01000000001
1EN00000000000000000000001
11111111111111111111111111
