111111111111111111
1EC000000P00000N01
111111111111111111
